S,S,S,S,S,S,S,S,S,S,S,S,S,S,S,S,S,S,S,S,S,S,S,S,S,S,S,S,S,S,S,S,S,S
S, , , , , , , , , , , , , , , , , , , , , , , , , , , , , , , , ,S
S, , , , , , , , , , , , , , , , , , , , , , , , , , , , , , , , ,S
S, , , , , , , , , , , , , , , , , , , , , , , , , , , , , , , , ,S
S, , , , , , , , , , , , , , , , , , , , , , , , , , , , , , , , ,S
S,S,S,S,S,S,S,S,S,S,S,S,S,S,S,S,S,S,S,S,S,S,S,S,S,S,S,S, , , , , ,S
S,S,S,S,S,S,S,S,S,S,S,S,S,S,S,S,S,S,S,S,S,S,S,S,S,S,S,S, , , ,a,b,S
S, , , , , , , , , , , , , , , , , , , , , , , , , , , , , , , , ,S
S, , , , , , , , , , , , , , , , , , , , , , , , , , , , , , , , ,S
S, , , , , , , , , , , , , , , , , , , , , , , , , , , , , ,S,S,S,S
S, , , , , , , , , , , , , , , , , , , , , , , , , , , , , ,S,S,S,S
S, , , , , ,S,S,S,S,S,S,S,S,S,S,S,S,S,S,S,S,S,S,S,S,S,S,S,S,S,S,S,S
S, , , , , ,S,S,S,S,S,S,S,S,S,S,S,S,S,S,S,S,S,S,S,S,S,S,S,S,S,S,S,S
S, , , , , , , , , , , , , , , , , , , , , , , , , , , , , , , , ,S
S, , , , , , , , , , , , , , , , , , , , , , , , , , , , , , , , ,S
S,S,S,S, , , , , , , , , , , , , , , , , , , , , , , , , , , , , ,S
S,S,S,S, , , , , , , , , , , , , , , , , , , , , , , , , , , , , ,S
S,S,S,S,S,S,S,S,S,S,S,S,S,S,S,S,S,S,S,S,S,S,S,S,S,S,S,S, , , , , ,S
S,S,S,S,S,S,S,S,S,S,S,S,S,S,S,S,S,S,S,S,S,S,S,S,S,S,S,S, , , , , ,S
S, , , , , , , , , , , , , , , , , , , , , , , , , , , , , , , , ,S
S, , , , , , , , , , , , , , , , , , , , , , , , , , , , , , ,A,B,S
S, , , , , , , , , , , , , , , , , , , , , , , , , , , , , ,S,S,S,S
S, , , , , , , , , , ,a,b, , , , , , , , , , , , , , , , , ,S,S,S,S
S,S,S,S,S,S,S,S,S,S,S,W,W,S,S,S,S,S,S,S,L,L,S,S,S,S,S,S,S,S,S,S,S,S
S,S,S,S,S,S,S,S,S,S,S,S,S,S,S,S,S,S,S,S,S,S,S,S,S,S,S,S,S,S,S,S,S,S