S,S,S,S,S,S,S,S,S,S,S,S,S,S,S,S,S,S,S,S,S,S,S,S,S,S,S,S,S,S,S,S,S,S
S, , , , , , , , , , , , , , , , , , , , , , , , , , , , , , , , ,S
S, , , , , , , , , , , , , , , , , , , , , , , , , , , , , , , , ,S
S, , , , , , , , , , , , , , , , , , , , , , , , , , , , , , , , ,S
S, , , , , , , , , , , , , , , , , , , , , , , , , , , , , , , , ,S
S,S,S,S,S,S,S,S,S,S,S,S,S,S,S,S,S,S,S,S,S,S,S,S,S,S,S,S, , , , , ,S
S,S,S,S,S,S,S,S,S,S,S,S,S,S,S,S,S,S,S,S,S,S,S,S,S,S,S,S, , , ,a,b,S
S, , , , , , , , , , , , , , , , , , , , , , , , , , , , , , , , ,S
S, , , , , , , , , , , , , , , , , , , , , , , , , , , , , , , , ,S
S, , , , , , , , , , , , , , , , , , , , , , , , , , , , , ,S,S,S,S
S, , , , , , , , , , , , , , , , , , , , , , , , , , , , , ,S,S,S,S
S, , , , , ,S,S,S,S,S,S,S,S,S,S,S,S,S,S,S,S,S,S,S,S,S,S,S,S,S,S,S,S
S, , , , , ,S,S,S,S,S,S,S,S,S,S,S,S,S,S,S,S,S,S,S,S,S,S,S,S,S,S,S,S
S, , , , , , , , , , , , , , , , , , , , , , , , , , , , , , , , ,S
S, , , , , , , , , , , , , , , , , , , , , , , , , , , , , , , , ,S
S,S,S,S, , , , , , , , , , , , , , , , , , , , , , , , , , , , , ,S
S,S,S,S,a,b, , , , , , , , , , , , , , , , , , , ,a,b, , , , , , ,S
S,S,S,S,S,S,S,S,S,S,S,S,S,S,S,S,S,S,S,S,S,S,S,S,S,S,S,S, , , , , ,S
S,S,S,S,S,S,S,S,S,S,S,S,S,S,S,S,S,S,S,S,S,S,S,S,S,S,S,S, , ,a, , ,S
S, , , , , , , , , , , , , , , , , , , , , , , , , , , , , ,b, , ,S
S, , , , , , , , , , , , , , , , , , , , , , , , , , , , , , , , ,S
S, , , , , , , , , , , , , , , , , , , , , , , , , , , , , ,S,S,S,S
S, , , , , , , , , , , , , , , , , , , , , , , , , , , , , ,S,S,S,S
S,S,S,S,S,S,S,S,S,S,S,W,W,S,S,S,S,S,S,S,L,L,S,S,S,S,S,S,S,S,S,S,S,S
S,S,S,S,S,S,S,S,S,S,S,S,S,S,S,S,S,S,S,S,S,S,S,S,S,S,S,S,S,S,S,S,S,S