S,S,S,S,S,S,S,S,S,S,S,S,S,S,S,S,S,S,S,S,S,S,S,S,S,S,S,S,S,S,S,S,S,S
S,a,b,a,b,a,b,a,b,a,b,a,b,a,b,a,b,a,b,a,b,a,b,a,b,a,b,a,b,a,b,a,b,S
S,a,b,w,b,f,b,a,b,a,b,a,b,a,b,a,b,a,b,a,b,a,b,a,b,a,b,a,b,a,b,a,b,S
S,a,b,a,b,a,b,a,b,a,b,a,b,a,b,a,b,a,b,a,b,a,b,a,b,a,b,a,b,a,b,a,b,S
S,a,b,a,b,a,b,a,b,a,b,a,b,a,b,a,b,a,b,a,b,a,b,a,b,a,b,a,b,a,b,a,b,S
S,S,S,S,S,S,S,S,S,S,S,S,S,S,S,S,G,G,G,G,S,S,S,S,S,S,S,S,b,a,b,a,b,S
S,S,S,S,S,S,S,S,S,S,S,S,S,S,S,S,S,S,S,S,S,S,S,S,S,S,S,S,b,a,b,a,b,S
S,a,b,a,b,a,b,a,b,a,b,a,b,a,b,a,b,a,b,a,b,a,b,a,b,a,b,a,b,a,b,a,b,S
S,a,b,a,b,a,b,a,b,a,b,a,b,a,b,a,b,a,b,a,b,a,b,a,b,a,b,a,b,a,b,a,b,S
S,a,b,a,b,a,b,a,b,a,b,a,b,a,b,a,b,a,b,a,b,a,b,a,b,a,b,a,b,a,S,S,S,S
S,a,b,a,b,a,b,a,b,a,b,a,b,a,b,a,b,a,b,a,b,a,b,a,b,a,b,a,b,a,S,S,S,S
S,a,b,a,b,a,S,S,S,S,S,S,S,S,S,S,S,S,S,S,S,S,S,S,S,S,S,S,S,S,S,S,S,S
S,a,b,a,b,a,S,S,S,S,S,S,S,S,S,S,S,S,S,S,S,S,S,S,S,S,S,S,S,S,S,S,S,S
S,a,b,a,b,a,b,a,b,a,b,a,b,a,b,a,b,a,b,a,b,a,b,a,b,a,b,a,b,a,b,a,b,S
S,a,b,a,b,a,b,a,b,a,b,a,b,a,b,a,b,a,b,a,b,a,b,a,b,a,b,a,b,a,b,a,b,S
S,S,S,S,b,a,b,a,b,a,b,a,b,a,b,a,b,a,b,a,b,a,b,a,b,a,b,a,b,a,b,a,b,S
S,S,S,S,b,a,b,a,b,a,b,a,b,a,b,a,b,a,b,a,b,a,b,a,b,a,b,a,b,a,b,a,b,S
S,S,S,S,S,S,S,G,G,G,S,S,S,S,S,S,G,G,G,S,S,S,S,S,S,S,S,S,b,a,b,a,b,S
S,S,S,S,S,S,S,S,S,S,S,S,S,S,S,S,S,S,S,S,S,S,S,S,S,S,S,S,b,a,b,a,b,S
S,a,b,a,b,a,b,a,b,a,b,a,b,a,b,a,b,a,b,a,b,a,b,a,b,a,b,a,b,a,b,a,b,S
S,a,b,a,b,a,b,a,b,a,b,a,b,a,b,a,b,a,b,a,b,a,b,a,b,a,b,a,b,a,b,a,b,S
S,a,b,a,b,a,b,a,b,a,b,a,b,a,b,a,b,a,b,a,b,a,b,a,b,a,b,a,b,a,S,S,S,S
S,a,b,a,b,a,b,a,b,a,b,a,b,a,b,a,b,a,b,a,b,a,b,a,b,a,b,a,b,a,S,S,S,S
S,S,S,S,S,S,S,S,S,S,W,W,W,S,S,S,S,S,S,L,L,L,S,S,S,S,S,S,S,S,S,S,S,S
S,S,S,S,S,S,S,S,S,S,S,S,S,S,S,S,S,S,S,S,S,S,S,S,S,S,S,S,S,S,S,S,S,S